1111111111111111111
100000000E000000001
1000000000000000001
1100000000000000011
1110000000000000111
1111000000000001111
1111100000000011111
1111110000000111111
1111111000001111111
11111111CCC11111111
111111111P111111111
1111111111111111111
