1111111111111111111111111111111111111111111111111111111111111
1000000000000000000000000000000000000000000000000000000000001
1010010100100000101001000000010100000011111111110000000000001
1010010010101010001001000000010101000000000000001111111111001
1000000000000000000000000000000001000000000000000111111000001
100000000000000000000000P000000000000000000000000000000000001
1000000000000000000000000000000000000000000000000000000000001
111111111111111111111CCCCCCCCCCCCCCCCCCCC11111111111111111111
1111111111111111111111111CCCCCCCCC111111111111111111111111111
1000000000000000000000000000000000000000000000000000000000001
1100000000000000000000000EEEEEEEEE000000000000000000000000011
1111111111111111111111111111111111111111111111111111111111111
