1111111111
1P00000001
1111111001
1000000001
1001111111
1CCCCCCCC1
1111111001
1000000001
1001111001
1001111001
1001111001
1001111001
1101111001
1101111001
1101111001
1100001111
1110000111
1111001111
1111EE1111
1111111111
