1111111111111111111111111111
1111111111111111111111111111111
1000000000000000000000000000001
1000000000000000000000000000001
1000000000000000000000000000001
1000000000000000000000000001
1000000000000000000000000000001
1000000000000000000000000000001
1000000000000000000000000000001
1000000000000000000000000000001
1000000000000000000000000000001
100000000000000a000000000000001
1000000000000000000000000000001
111111111111111111111111111111111
1111111111111001111111111111111
